000000000000000000000000000000000
000000000000000000000000000000000
000000000000000000000000000000000
000000000000000000000000000000000
000000000000000000000111111111111
000000000000000000000000000000000
000000000000000000000000000000000
000000000000000000000000000000000
000000000000000000000000000000000
000000000000000000000000000000000
000111111111000000000000000000000
000111100000000000000000000000000
000111100000000000000000000000000
000000000000000000000000000000000
000000000000000000000111111111111
000111100000000000000000000000000
000100100000000000000000000000000
000100100000000000000000000000000
000100100000000000000000000000000
000100100000001111000000000000000
000111100000000000000000000000000
000000000000000000000000000000000
000000000000000000000000000000000
111111111000000000000000000000000
000000000000000000000000000000000
