000000000000000000000000000000000
000000000000000000000000000000000
000000000000000000000000000000000
000000000000000000000000000000000
000000000000001111100000000000000
000000000000001111100000000000000
000000000000000000000000000000000
000000000000000000000011111111111
000000000000000000000000000000000
000000000011111000000000000000000
000000000011111000000000000000000
000000000000000000000000000000000
000000000000000000000000000000000
000000000000000000000000000000000
111111110000000000000000011111111
111111110000000000000000011111111
111111110000000000000000011111111
111111110000000000000000011111111
111111110000000000000000011111111
111111110000000000000000011111111
111111110000000000000000011111111
111111110000000000000000011111111
111111110000000000000000011111111
111111110000000000000000011111111
111111111111111111111111111111111
